12 14 1 5 13
-1 -1 -1 -1 -1 -1 -1 -1 -1 -1 -1 -1
-1 0 0 0 0 0 0 -1 0 0 0 -1
-1 0 0 -1 0 -1 0 6 0 5 0 -1
-1 0 -1 0 0 0 0 -1 0 0 -1 -1
-1 0 -1 0 -1 0 0 0 0 0 -1 -1
-1 -2 0 0 1 0 0 2 3 0 0 -1
-1 0 0 0 0 -1 -1 0 13 0 0 -1
-1 0 -1 -1 -1 0 0 0 4 0 0 -1
-1 0 0 0 0 0 -1 -1 -1 -1 0 -1
-1 0 0 11 0 0 0 0 -1 0 0 -1
-1 0 0 10 0 9 0 0 7 0 0 -1
-1 0 -1 0 0 0 8 -1 -1 0 0 -1
-1 0 0 12 0 -1 0 0 0 0 0 -1
-1 -1 -1 -1 -1 -1 -1 -1 -1 -1 -1 -1