20 20 5 5 42
0 0 -1 0 0 0 -1 -1 0 -1 0 0 1 -1 0 0 0 0 -1 2
0 -1 0 0 0 0 0 0 3 0 0 0 4 5 -1 0 0 -1 -1 0
0 -1 -1 0 6 0 7 0 0 0 8 0 -1 0 0 0 0 -1 -1 9
0 0 0 -1 0 0 10 0 0 11 12 0 -1 0 0 0 0 0 0 13
0 -1 -1 0 0 0 0 0 0 0 0 -1 0 0 0 14 0 0 0 0
-1 0 -1 0 15 -2 0 0 0 0 0 0 -1 0 16 0 0 0 -1 0
0 0 -1 -1 -1 0 0 0 0 0 -1 0 0 -1 0 17 18 -1 0 0
-1 0 0 0 -1 0 0 0 -1 19 -1 -1 -1 0 0 0 0 0 20 -1
0 0 0 -1 0 21 0 0 0 -1 0 -1 0 22 0 0 0 -1 0 0
0 0 23 -1 0 0 -1 0 0 24 0 0 0 -1 0 0 0 0 0 25
0 0 0 -1 0 -1 0 0 0 0 26 0 0 0 27 -1 0 0 0 0
-1 0 0 0 0 0 -1 0 28 29 0 0 30 31 0 -1 0 0 0 0
0 -1 -1 0 0 0 0 -1 0 0 0 -1 0 0 0 0 0 32 -1 0
0 -1 0 0 0 0 0 0 0 0 -1 33 0 0 -1 -1 -1 0 -1 -1
0 0 -1 -1 0 0 0 -1 -1 0 0 0 -1 0 -1 0 -1 0 0 0
0 34 0 0 0 0 0 0 -1 0 0 0 -1 0 -1 35 0 0 0 0
-1 0 0 0 -1 0 0 0 0 0 -1 36 -1 0 -1 0 -1 0 0 0
0 0 -1 0 -1 -1 0 -1 37 -1 -1 0 0 0 0 0 -1 0 0 0
0 -1 38 -1 0 0 0 0 -1 0 0 0 0 -1 -1 0 -1 39 0 0
-1 0 0 0 -1 40 0 0 0 0 0 0 41 -1 0 0 42 0 0 0