30 20 5 5 64
0 -1 -1 0 0 0 0 -1 0 0 1 0 0 0 -1 -1 0 0 0 0 0 0 0 0 0 0 -1 0 0 0
0 0 0 0 0 0 -1 2 0 3 -1 -1 -1 -1 0 -1 0 0 0 -1 0 0 0 0 0 0 0 -1 0 -1
0 0 0 -1 0 0 -1 0 0 0 0 0 -1 0 0 0 0 0 -1 0 -1 4 -1 0 0 0 0 0 0 5
0 0 6 0 7 -1 8 0 0 -1 -1 -1 0 -1 -1 0 0 0 0 0 -1 0 0 0 0 -1 9 0 0 0
-1 0 0 0 0 0 0 -1 -1 0 0 0 -1 0 0 0 0 0 0 0 -1 0 0 10 0 0 0 0 -1 -1
0 0 0 0 0 -2 -1 0 0 11 -1 0 0 0 0 0 12 13 0 0 0 0 0 -1 0 0 0 0 14 0
15 0 0 0 -1 0 0 0 16 17 -1 0 -1 0 -1 18 0 0 0 0 -1 19 0 -1 -1 0 0 0 -1 0
0 0 0 0 0 -1 20 0 0 0 -1 -1 0 -1 0 0 0 0 0 -1 0 0 -1 -1 0 21 0 0 0 0
0 0 0 -1 -1 0 0 -1 -1 -1 0 0 22 23 -1 0 24 0 0 -1 0 0 0 0 0 0 -1 0 25 26
0 27 -1 0 -1 28 0 -1 29 0 0 0 30 0 -1 -1 31 0 0 0 32 -1 0 -1 -1 0 0 0 -1 0
0 0 0 0 0 0 -1 0 0 0 33 0 0 0 0 0 0 34 35 0 0 0 0 0 -1 0 0 0 0 36
0 37 0 0 0 0 0 0 0 0 0 -1 -1 -1 -1 0 0 0 38 39 0 -1 -1 0 0 0 0 0 0 0
0 0 0 0 -1 -1 0 -1 0 0 0 0 0 0 0 0 -1 0 0 -1 0 0 0 0 0 -1 0 -1 0 0
0 0 0 0 0 0 0 0 0 -1 -1 -1 40 41 0 0 0 -1 0 0 -1 0 -1 0 -1 0 42 43 44 0
0 -1 0 -1 -1 45 0 46 0 0 -1 47 0 -1 0 0 0 0 0 -1 -1 0 0 0 -1 -1 -1 -1 0 0
0 -1 0 0 48 0 -1 0 0 0 0 0 0 49 0 0 0 -1 0 -1 -1 -1 0 -1 0 50 0 -1 -1 0
-1 0 -1 0 0 0 0 0 0 0 -1 0 0 0 0 -1 0 0 -1 0 -1 51 0 -1 0 52 0 0 -1 0
0 -1 0 0 0 0 0 0 53 0 0 0 0 0 -1 0 0 0 -1 -1 0 54 0 0 0 -1 55 0 0 56
0 0 -1 -1 0 0 -1 0 0 0 0 0 0 -1 0 0 -1 0 0 0 57 0 0 58 0 0 -1 0 0 0
0 59 0 -1 0 0 0 -1 -1 60 0 0 0 0 -1 -1 0 0 0 61 -1 -1 0 0 62 63 0 0 0 64