40 20 5 5 51
0 0 0 0 0 0 0 0 0 1 -1 0 0 0 2 -1 0 0 0 0 -1 0 3 0 0 0 0 0 -1 0 -1 0 0 -1 0 0 0 0 0 -1
-1 0 0 0 -1 0 0 -1 -1 4 5 0 0 -1 0 -1 0 0 0 0 0 0 -1 0 0 -1 0 0 0 0 0 0 0 6 0 0 0 -1 -1 0
0 -1 -1 7 0 0 0 0 8 0 -1 0 -1 0 0 0 0 0 0 0 0 -1 0 -1 0 0 0 0 9 0 -1 0 -1 0 0 0 0 0 0 0
0 0 -1 0 0 0 0 0 10 0 0 0 0 0 -1 0 11 0 0 0 0 0 -1 0 -1 -1 12 -1 0 0 0 0 0 0 -1 0 0 0 0 -1
0 -1 0 0 0 0 -1 0 0 0 0 0 0 -1 0 0 0 13 0 0 0 0 0 0 0 -1 -1 0 0 0 0 0 0 -1 14 0 0 -1 0 0
0 0 0 0 -1 -2 0 0 -1 -1 0 0 0 -1 0 0 0 15 -1 0 0 0 0 0 16 0 0 0 0 0 0 0 0 -1 0 0 0 0 -1 -1
-1 0 0 0 -1 -1 0 0 -1 0 0 0 0 -1 -1 0 -1 -1 -1 0 0 0 -1 0 0 -1 0 -1 0 0 0 -1 0 0 0 0 0 -1 0 0
0 17 -1 0 0 -1 -1 0 0 -1 0 0 -1 0 0 0 -1 0 0 0 18 -1 0 0 -1 0 0 0 -1 0 -1 0 0 0 -1 0 0 0 0 0
0 0 -1 0 19 -1 0 0 0 0 0 0 0 0 -1 0 0 0 0 -1 -1 0 0 0 0 0 0 -1 0 0 -1 0 0 0 0 0 0 0 0 0
0 0 -1 0 0 -1 20 -1 0 0 -1 21 0 0 0 -1 0 0 -1 0 -1 0 22 -1 0 0 -1 0 -1 0 0 -1 0 0 0 -1 -1 0 0 0
-1 0 0 0 0 23 -1 0 0 -1 0 0 0 0 0 0 0 0 0 0 0 0 0 0 0 0 0 0 0 0 0 0 -1 -1 0 0 0 0 0 0
0 -1 0 0 0 -1 -1 24 -1 0 0 0 -1 0 25 0 0 -1 0 0 0 0 0 -1 -1 -1 26 27 0 0 28 -1 0 0 0 0 0 0 0 -1
0 0 -1 0 0 -1 0 0 0 0 0 0 0 0 -1 -1 0 0 0 0 0 0 0 0 0 0 -1 0 0 0 0 0 -1 0 0 29 0 0 -1 0
0 0 0 -1 0 0 0 0 0 0 0 0 -1 0 -1 -1 -1 30 0 0 0 -1 0 0 0 0 0 -1 0 0 0 0 0 -1 0 0 0 -1 -1 31
0 -1 0 0 0 -1 -1 0 -1 -1 0 0 0 32 0 0 0 0 0 0 0 -1 0 -1 0 0 0 -1 33 0 -1 -1 0 -1 0 -1 0 0 -1 0
0 0 0 0 0 0 0 0 34 -1 0 0 -1 0 -1 -1 -1 0 0 0 0 -1 -1 -1 0 0 0 0 0 35 0 -1 -1 0 0 0 -1 0 -1 0
-1 -1 -1 -1 -1 0 0 0 36 37 0 0 0 0 0 -1 0 0 0 0 -1 0 0 -1 0 -1 0 0 0 38 0 0 39 0 0 0 0 0 0 -1
0 40 0 0 0 0 0 0 0 0 0 41 -1 0 -1 -1 0 0 0 0 -1 0 0 42 -1 0 -1 -1 0 -1 -1 0 0 -1 0 0 43 0 0 0
0 -1 -1 0 0 0 44 0 -1 45 -1 -1 0 0 -1 -1 0 0 0 0 -1 -1 46 0 0 47 0 48 0 0 0 0 0 49 0 0 -1 0 0 0
0 0 -1 -1 0 0 0 0 0 0 0 0 0 -1 0 0 -1 0 -1 0 0 0 0 0 0 0 0 -1 0 0 -1 0 0 0 0 0 50 51 0 0